Chloe Smith  -  Briley Wiggs
Dakota Johnson  -  Harlee Parker
Michael Mcdaniels  -  Jehovah Stone
Trenton Porte  -  Kenzie Brown
Krumm  -  Star Dial
Dylan Evans  -  Logan Nichols
Codie Anthony  -  GoDair
Kyna Holman  -  Ashley Millan
Vicky Romo  -  Kaitlynn Strong
Ethan Hickson  -  Lupita Garcia
Matthew Recer  -  Christian Case
Ryan Perry  -  Dominik Rudman
Callie Russell  -  Maya Alley
Tiffany Michael  -  Samantha Woodard
James Blaylock  -  Ashley Guevara
Jeremy Drake  -  Perkins
Alicianna Nunez  -  Clay Carpenter
Jake Deshazo  -  Bobbi Dunlap
Livia Mancinella  -  Sara Larson
Clara Pruitt  -  Peyton Estes
Lisseth Garcia  -  Colton Tumlinson
Brooklyn Moore  -  Emma Carpenter
Summer Tobar  -  Ashton Milner
Riley Kitchens  -  Colten Smitherman
Chase Williams  -  Drew Miller
Courtney Limer  -  Anthony Moreno
Matthew Rochester  -  Cheek
Cassidy Gandy  -  Joel Adams
Noah Russell  -  Greg Wells
Jaden Hammonds  -  Vincent Walker
Corey Smith  -  Gracie Herron
Joseph Womble  -  Daniel Beasley
Caleb Bandy  -  Chistopher Thorne
Daisy Jones  -  Hicks
Madisen Kulsa  -  Sam Dockins
Cadence Pace  -  Chelcie Collum
Nicholas Martin  -  Gracey Pitchford
Trent Kirkpatrick  -  Matthews
Gage Castillo  -  Dylan Worth
Danny Stout  -  Cade Adair
